
NO    ./textures/wall.xpm
SO ./textures/wood.xpm
EA    ./textures/bush.xpm
WE ./textures/window.xpm

S ./textures/tonneau.xpm

F 153,    76,    0
C 10, 206,   255


11111111111111111
10011100000101111
10001100000001111
10020000000000111
10000000002000001
11110000000N00001
11110000000000001
10000000000110001
11111111111111111