
NO            ./textures/wood.xpm
SO ./textures/wood.xpm
EA ./textures/wall.xpm
WE ./textures/wall.xpm

S ./textures/tonneau.xpm
F 200,             255,255
C 102  ,102,255

1111111111111111111111111111111111111111111
1000000000000000000000000000000000000000001
1000100000000000000000110000000000000000001
1000000000000000000000110000000000000000001
1000000000000000000000000000000000000000001
1000000000000000000000000000000000000000001
1000000000000000000000000000000000000000001
1000000000000000000000000000000000000000001
1000000000000000000000000000000000000000001
1000000000000000000000000000000000000000001
1000000000000000000000000000000000000000001
1000011111000000000000000000000000000000001
1000011111000000000000000000000000000000001
1000011111000000000000000000000000000000001
1000011111000000000000000000000000000000001
1000011111000000000000N00000000000000000001
1000000000000000000000000000000000000000001
1000000000000000000000000000000000000000001
1000000000000000000000000000000000000000001
1000000000022220000000000000000000000000001
1000000000022220000000000000000000000000001
1000000000022220000000000000000000000000001
1000000000022220000000000000000000000000001
1000000000000000000000000000000000000000001
1000000000000000000011111111111111111000001
100000000000000000001               1000001
100000000000000000001               1000001
100000000000000000001               1000001
100000000000000000001               1000001
100000000000000000001               1000001
100000000000000000001               1000001
100000000000000000001               1000001
100000000000000000001               1000001
100000000000000000001               1000001
1000000000000000000011111111111111111000001
1000000000000000000000000000000000000000001
1000000000000000000000000000000000000000001
1111111111111111111111111111111111111111111